DapperWhinny91	DBDFHFBDBFDDDDBHBBFFBDBBHFFFFFBFBFBHFFDHDFBDDDDDBBFFFHDFHBFHHFFBHFDDHBFFBBBDBDHFBHFFFDFHFBFHFBHFDDFHBBBBHHDFDBHDDDHBFHFHFFFHFHHFBHFDHDDDBBDDHDBHHBHFBFBHFHBFFBHHFHFHBBDHHBDFDDBDDHFFHBHDFDDHFFDHDBBFHDHB
HungryMane41	HFFHHFHHBBFFHDDBHBFDFDDFFBHBHDBBHHBBHFHFHFHBBHHFFHDBDDHFHBHDDFDHHFFHBFBFFDFFHDBDBDFDFHHBFDBDHBHBDDHBFBDBFHDDHDDFBFBHBHBFHDDHHFDHDHFDDBFFFFBDBDBBHBDFBDHBDFDHBHBHFFBBDBHFDHDFFBHFBDFHFDFBHDFHBHDHBHDFFHDB
DapperMane21	DHBDDBHHFFDDFHBBDFBHFDFFFFDFFHDHHFDHBBDHHBFDBDFHBFHDFFHFDHDHDHHBBFFDBFFBHHDBDFDDBDDDHDBDDFFHHDFFFDDDHHBDHDHBBHHFHBFDBHFFFBBHBBBBFBDDHHBBFFDHBHDDBBFFDDHDDDBFFHFFBBFFFHBBFHFFFHFFFDBFFHFBHFHDBFFHFDDHFDFB
GallopingTrotter65	HFDHHDBDDDHBBFDDFFFBHFHBHDFFDDHHBDFFBFHDFHBHHBDFHDDFHFBFHBFHBDBBFDBDDBHBDHDFHBDFHBDHHHBHHDFFBFFDBDFHDBHFHDDBHFFBFFFHDFBHFBBBDDHHFHBFDHDBDDBHBBHHDBBDHFFBBFHFBBHHBDHHBFBDHDDBHHFBHHFDBFFBHHDBHHDDDHDDBDHB
GallopingHoof33	DHFDFFHHFDHFFDBHFHBBFBHDDBFFFFHBBBDBHDHBDBBBDHBDFHBDHBDFHFHBBDFHHDDBDFHFBDFFHHHBHFFBBFBBDFBHBFFHBDBBHHHDBHHHBDDDHFDFBHDFHHBDHHDFHBBFDDDBFHHDDHHFBDDDFHBFBHFDFFHFFDHHDDHHHHFFHBBHDBHFBBFBFBBFDBHFBHDDBDHD
SneakyWhinny3	FFDFFBBHDDBFHFHFDDHBHFDFFHFHFHFBHHHFFHHBBHHDFBDFFHBHHHDFDHDDDFHHBHHHHHFDHHFFFDBFFDFBFDDDFBDBBDDBBHFDHBDFFBFDFBBHBBBDBHBBBBFBBBFFFFDHFBDBFDHFBHBFFFFBBHHHFBFFFFBBHDDDFBDDFHFFFDDDDBDDBHHDBDDHHBFBDDFFDHBF
DapperPony16	DHHBBHHBHBHHFHHBDHDBDDDBBHFHBHDHFBBBDDBFFFBFBHBBHHHBHBHDDDFBBBFFHFFFFHHDDHFHFFFFHHFDDFDHFDHFFHDBDFBHFHBDHHHHDDHDHBBDBHDBDHHBBHHFDBFDDHFFFHBHFFHHDFHHDFFHHBHFHHDFBBFHHBDDDHBFHDDHFDBFHDDBBBHFFHHBDBDFFHBH
SneakyTrotter95	FDFFBBBHBFBHFBBDHBDDFFBHHDDFHFBHDFFFHFFFHFHFHDFDDFFFDHBFBFHHBFDFFFBFDFFHFHHFFDBFBHHDFDFHDDDFDHDBHFFDBDFBDBHHFDBBHHDFBBHBHFDFDDBDFFFHBHHDHDFHBHHFDDFHFDDFBHDFHBDDDBFFDDFBBDHBBHBDFDFDDFDDBDFHBBFBDDBDBDDB
SneakyPony41	DDHBDHFFHDDBDFHHBFBBHBDDHDBDFHDHDFDHDBHHBBHHDBHHHBDFDBBDDFDFHFHDHBFHBFFHFDHFDFHBHHDFDHFBBDBFDDFDDBBFDBDFDBDHFHBBFHFFHBDBHFBDFFBFHDBHHHHFBDFHDDDBHBFFBFBHDHFBBDBBFBHDHHDHBFBHHDDHHDBDDFHHFFBBFDHHBHDFDHBB
HungryMare80	FBFFDFHDDDDBFFBFDHHFHHBHBBFBHDDDDDBDBDFDDHDDBFFFDDFBHDFHBFBFFDFDBHHBHHFBFFHDFHHDFFHHHBBFHDHBDHDFFFFHHHBHBHHFDDDFBFDBDDDBDDDFBDFBFDFBFBHHFDBHBFFHHBHDFDHFBDHBHHDBDBBDDDFDHDBDFBDFBDBBHDDDBFFHHBBHDFFBDHBD
CharmingHoof96	DHBHFDBBBBBFBHBFBHBDBDHBHFFFBDBFBFFBDFHHFHFDBDFBFFHFFFFHFHFFDFDHDHFFHDBHFBBFBDBFHHDHHDHFHFBDHBHHBHHBDFHBFFHBBDDHDFFDFFHBBBBHFFHFBBHFBHHHFBDHHDHBDHHHDHFFHDHHBDDHBDBHHHHDDBDBBBHBFFHHBDDDDBBBHDBHFFDDHDHB
HungryMane48	FFBFFDHDDDFDDBFFHBHBDFHDDHHHFFDDDHFDFDBBBHBFFHHDFHFHFFBFHFFFBHDFDBFHBBHHHBHDFFHBDHDBDDFFDBFFDDFFBFFHDHBBBFFDDBDDDBBBFFDBBBDFHFFHDDFBBFFFFHDFBFFBDHFBHFFHFDBHHHBFDBFHBDDHDFDFHHBHFBBBBBHBDHHDHFDHDDBBHDDH
HungryGalloper34	BBDBDBBBBBFDBHFHFDFBBHDHFDFHFHFFDBFDBDDFBHHBBDHHDHHBFDBFHBBHBDDHDDFFBHDBDBFDDDHFHBHFBFBDFFBBBFBDHBFBDDFFFDDBDDFDFHHHBDHFHHFDFFHFBFDBFDHFBFFFBFBBHDFBBHHFDHDBFBHHDDFHBDBDBDBBHDBHBBHDBHBBHHFHHBBDDFFBHBFF
HungryTail60	HHDBHDHDFFHHHFFDDFFDBHBBFHDBHHHFFFHBBFFDDDBBHFHDBDHDBBFDDDBBDBDFFFBDBHFDDBDHBHHBHBFDBFFFHFFDFDHBFHHBBDBDHDHFBBDHDHDHBBHHFFDBBDBHDFDBBHFHHBHHBHDHBFFBHFDHDDDFBFHFDFHBHBBHHFFDHDHBFDHFDDBFFDFDHHBBHBFHHHFF
HungrySteed39	HFFFDBFFFFBHHFDHBBHFHDHDFHHHFHFHDHFHFFBBDFFDHFBFDBBFHHFHBBBFDFFBBHDDBDDFFHDFDDHBDHBBFFBBBFDHDBFDDBDBFDHDFBBBBFDBFDFHFBBHDBBHDFDDFFHHFDBBBHHDDDFBHHBDDHBFBHHBBHFHDHHBFHFFBBBHDFDBDDFHHHBHFFDHFBHHHDDBBFDH
SwiftTrotter51	HFBFDHDDFBHDBDFFDFBHHFHHHDBHFFBHHHFDDBDFFBDHHDHBBHFFBDHHFHFHBHDBBBHFDFFFFFFHFBBHFBBFBHDHFHBBBFBDBHFBHDHBFHBHBHBFDHHHFBBFBBHDHHDFFHDBBDBFHFHFHBDDFDDDDHBDBDBHFDDDFHHDHHDFHHDFFBBHHBDDDFBDDFFBDDFBHBDBHBHH
HungryHoof31	HDDBFFDDDFBBDDFHFFDDFDHDFBDHHDFBFDBFHDBBHDFDHHFHHHDFDBBDBHFFFFFFHHFBFHFHDBFBDFHBFFHBDHDDFHDBHFBFHFHDFBFBDDHHDDDHBBHFDBFHFHDHDDFHHBBHHHFFFFFHBFBDHFFDHFFDBFBFHBHHBBBDHDFFFHDFDBDDHHHFDBDDDFHHHHDFFDHFHFDB
PrancingTrotter52	HFBHHDFFHDHFFBBFFBFHFBHHBDHHDDDFDFDHDFDDHHFFFFDHBHBBFHDDBBBDFDDBFBDBFBHFDDBHBBDFHFDFHBHFBBFFFDBBFBDDBDHHBHDFDDHHFFHDBBBHDHDDHFBHFDHBBHHBDHFHHDDBFFDDFBFFBHFBHDDDFFFDHDBDHHHFHBHHBDHHHHDDHBFHFHFDFDHFDDHF
GallopingTrotter58	FHDDBFBFHDFDDHBDFHHBHBFDFHDHHBBHBDHFDBFDFHFHDBFBFFDHBBDDFHFFDFDHHHBHHBDHHFDHBHBFDHDBFDDBBFHDBBDDBDBDDBBDHDHFBDBDHBBBHBDDBBBHDDFDHBFFFDFBHDHBDFDDDHDDHDBDDDDBDBFBHDHBDDDBBHFHBDDHHHDDDBHHBDFDBHDFDBBFHBHB
MightyPony60	BFDFDHDFDDBHFBBHBFBFFFFHDFDDHDBDFBFFHHDHBFFFDHDBBDDBDHFBDDDBBHHFBBFBFFBFBFDFFDDBHFHDFDHBDFFBBFBFBHBDDFHBBFFHDHHFFBFHBHHDFFBDFBBBFDFFHDBDFBFFFHHFBBFDFBBBDHBFDBFDDFHDHDBFHBFFHFHHHHBFBBDBFHBFDHDBFBBHHBHF
SwiftMare15	BDBBHFDFDHHDBDBFHDHHBFDFHBHHFDFBDHBHBDHHFBFHDFBBDBBDDBFFFDBFDFHFHFBHBBDBDFHBDBBFBHFDBDFDDDBHDFBFFFHFHDBBBBBDBHDBBFFDBDDHBHHHHFBHDHDHDFHHBBDFHBDHBHFHFHFFBBFHFFFFBDDFHFBHBBBBDDDHDFHBDFBFBHDFDFFHFFDFHDBH
DapperTrotter75	DFFFHBFHHFFHDFFFHFBDHFHDFBFHFBFFFBFFHFDFFBBHDBHBBDBFBFDBDFFHFDDHFBHHHHBHHFFBBBBDFDDBFHFBFDHBHDDFHHFHHFHBBFDHDBBHFBBDHDDFHBBFFBFBDHHFHDFBHHFBBFBBFFFBBBHFHDDHDDDFBFDBHBFFDFHBHBBFDDBBHBDBBHFDHFBHHFDBHHFB
CharmingWhinny92	HDHDDDBDBBFFDFFDHHHFHDDDFHFBBFBBFBHDHBDDDFBBBBDFFFHHHHDHHBDHHFDBBBHBDFDHDBBHFDHBHBBBBDHDDBHBDDHBDBBBFBDHHHDFHFBFDBHHDFFDFDDDHDFBDFHFBHFFBDHHBHFHHHFFHHFHDFBFBDHBFFHFHFHDBBBFFFHFFFHBFDHHDBFHDHDFBBHDFHDB
HungryWhinny21	HFHFBDDHBDFDBFDBBBDBBDBDHHFDHDHBBHHDFDHHFDDHHDBBDFDHBDFBBBDFBDFHDBBFHDFDBDFHDDHHHHFDFHBFHDDDHBFDDDHHDFBDDFDFBFFHFBFHBDFFHBFFFHFDBHDFHHDBDHFFHDDBFDDFFFHBFHHBFFBDDBFFBFDHHFHDHFDFFHFDBFHFFFHHFFFHHFBDBFFH
SneakyMare80	FFBDBBFDHFDBBFBFBHDFBBFHFFBHBFBFHFBHFBBHFBHHFBBDHHBDFBBFBFDFDBFDHHDBFDBFBHBDHFDBHHDDBDBFFBFDDHDDDHHHBDHDHHDDHDDFHBDHHFFDHDDHDHFBFDBBHDBFBBDHHBFFBBBFHFBHFBBBDDBHDBFBDFDBBFHDDFDBBHBDDBBDBFDFFHDFFBBFFHBB
SwiftSteed86	DHHHFHBHBBHHFDDFFHDDBHDBHFHFHHDHBDFHFDDBHBHDFBBBHBFFBBBDBDHFHDFDFDDHDBDFBFHDBFFHFBHBHHHHFHDFHHFHBBHHHHBBBHFFHHHDHDHBHDHFBBHBFFFHFBDBHDFHBDHBDDHDBDHFDBFHHHHFDHDFFDDFBBHFHFBFFHBHDFFFHBBDBHHFFFDBFDDDHHBF
SwiftMare4	DFHDHBHFDBFDBFBHDDBFFHHBFHDHDFDFHHBDBHDFDFFFBBDBDHFFFBHHBBDBBFFFFBHFFHFDHBDBDHHDDHHDDFFFBDBFBBDHHHFFDFBHFFHHFDBHFFBBFBFDHDDDHFHHDFBFDDHBFBFBFFHBFBFBDHHFDDHFFDDDDHHBHBBFFDFDFBHFFBDBDDBDHHDFDDHHDDFFBDFB
MightyWhinny15	HBDDHFBHHFHDHBDBBHBFFFFDBFBBDDFHHDHFFFHHHFHDBFDDFFBFHFBFDHDFHHDDBDHBHDBBDDHBDBBBBHHFHFFFBFDHDHFBBDHBHBFHFHHHHFDDDDBFBHDHDFFFHHHFFHDHDBBFDBDFBBDBFBBBHBBBFBFDBBHBBBDHFBDFDDFHDBFHHFBHBHBFHHDFHHHBDDBDBDFD
HungryTrotter55	BFDHBFBDHFHDFFBDHHFDBHHBFHFDFHFHHBHBFHHHDDHHBBBHBDFHDFDDHBHBDBBHFDHBHFHFFDDDFFBFFHBFDBFHHBDFHDHBHHHFDHBBHBHDFBBDBBBFDBFHBFDBBDBBFHHBBDDHFHDBDFFHFBDFDBBDFHBBFBBDBHBHDFBFDBBHBHHDFFFBFHBDDBHDFBBHFFHFBDBH
CharmingTail36	HDFFBHDFFHFHBFDDDFHDHDDDFHFFBFBHHBHHHBFFBDHFHBFHFFDHFFBDDBBDHFFHFDBDBFDDBBHFDDBHFFBBHFFBDBDDBDHDHFHHHHFDFHFBBDDBDFDHDDFFHBDFHDDDBFBBFHDFBBHDHDHBFFHFHBDFFBHDHFFHBFFBFFFDBDBHBHFFDBHFBHHBDHHHHFFFBFHDDBFB
FuriousHoof96	HDDHBDFDBBDBHDDBFFFFDHDFDHBBDDDHHBHBDBFFBDBHFBFFFFHBFBFHFFHHDDBHDDHHBFDFHFBDFBHBDDHBFBFHBDFBFBHDHBHHDFDDFBFDBFFFHDDHFDFBBDHFDDBFDFHBBFFFBFBBBFHBFHDHBFHHDDFFBDDFHBFHHDDFFBFFFFBFDDDDHHDFBHHFDFHFFFFBHHDB
FuriousColt35	HFDFHDDHBFFFHDBBBFHDBHFFHBFHBFBDFBFHBFHBDHFDFBHHHBBFBDFFFFHFDHFFHHBBFBDBDFHFFFHHBHHBHBDFHDDFFBHHBBDHDBDHFBBFDFDBHBBFBDBBFDHFFBFDBHDBDFDFBBHHHFBBHDHFBDFHFBBBFDFDDDDBHHFBDDDHDHDFBFHHFFHDHHBDBFDDHFHBBFFF
GallopingColt36	HFBHFBFHBBBFDBDFFBDFDBBDHBBFBHHFDDHBHFHDBBHDFHDBDHHDFDHDDFHFHDDBDDFHHDDBFBHBHDDDFFBDBFDFFBBHDBBHFDHBBFHDDFFHDDBBDFHDHDHFBFFHHFBFBBFHDHHBDHBBHFFFDHDDBFFBHHDDFBBFFFHDFDDHFHBBHFFBHFHHHFFDHHBHDHBHDDFFHFBH
GallopingTail85	HFFFFDBBHDHBHFBHDHFDFFFFBHHFDDHBBFHHFHFDBBHBDBBHFHFBFDDFBBHHHDBFDFFFDFFFBBHBFBBHHBDBHBDHHBHHHFDBDFFHFHHHDDFDHBDDHFHHHBFDBDHDDFBHBBBHDBFBHDDBBDHHDDFDFFHFBHDDFDFFFFFDDBFHBBDHDFHBFDBHFDHBHBHFDHHHFFHBBBFF
PrancingSteed40	FFDHBHBFBFBHFDHFBHDHHDFFBFDHFBFDDFFFHHHBFBFHFFFFDDFBDDBHBDBDBFDHDDBHDBHHFDBBFDDDFFFDBBBFFHDHHFHDFHDFFDBFFDDDHFFBDBDBDHDDFFBDBBBBDDHDHBBHDHFHHBHFHBDBFFFHFBBFBDFHHBHDDBDFFDDHFHBBBDDHBBBFBDFFFFHDBBFBDFHD
DapperSteed8	DBBFFDHDFFBHDDDFFHDHHFDDDDDBFHBHBBBHHBFHBDDBBDBFFHBFFDDDHBFBFHHDFHDHFDDHBDHBDFHHFBDDBDFFBDFDFBHBDFDHFHDDFDFBHBDFBBDBHBDHFHFHFFBBFBDHHFBBFHFDHDFBFBBBBDFBFDHBBDHHBFDBBFFFDHFFDHBFHFDHFDDHHBFFHFFFBHBHBDHH
LazyHoof99	HHDHBFFDBFBBBHBFHHDFFDDBFBBHDFHDDDDHFBDFFFBBBBDHDBDHBBHFHFFDDFBHBDFBDBHHHDHHHDBDFDDBBFHFBHBHBFHDFBDBHFHDBFFDBFFHHBBBBDHBHFFDHFDDFHDBHDFFDHFBHDBDDFHBFHFBDHBDBFBFBHFDFFFDHHDHDDHHHFHDFDDFFFHHHDDDDDFHBHDF
PrancingHoof69	BDDFHFDDBBDHFDDBFBFHBBFFFFHBFFBBFHDHHFFDBHHBBBBHBHBBDBDFHFFHDFBHDFFFHDFBDHFHHDDDFDBBHFBHHDDDFBBDDFBFFDBHHHBBBFFDHBDHBFDHDBHDFFBBDDHHHDBBHDFDBFBFBDDBHHDBFHBDHFDHDHHDBFDDHHFDFFFFBFBBFHBFBDDFBFFDBFBHBFHD
MightyTrotter82	DDBBDHBHHFHDDBBFDFDDHDFBHHBBDBFFBHHHBBBFDBHDDFFDBDBHHFFBHFFDBBFBFHDDBBDDFHDHBBFDHBHBFHFFHBHBFDBHBHBDFFFBHBHFFFBHHHDDBHBBFBBFDFBFBDHDBDHHDBHFBHDFFHHDBDDHDDBHFFFFDFFFHDFDHHDBHDBHDBBFBBFHBBHBFDHFDDFHDFDF
SwiftMane76	FFDDBHBHDFBFFDDFHBDHDBDDFBBHBHHDDDBFHHFHBDHDFHDHFHDDHHFHDHFHFFBBDHDBFHBHHHDFFBDDHBDDFDHBFHDBFHBHDFBHBFBFHBFHFHBDHFBFHDBDDDDDDHFBHBFBDHBBFBBDHFBBHDHDFDBHHDDFBHFHFDHDFFHHDFBHFHBFBDBDBHDHFDDBBBFFDHBDBHDH
LazyHoof15	DDBHHHHBFFBDDFDDBFBFFHBBDFFDBDFFDBFHDFBFFDFFDFDBHDBBBHDBDFDHHFDFFFFHDDBFBHHHDFFDHBDFDBHFDFHBHBBBHBHBBBFBHFDDHHBDHBBHHDDFBBBHFBDBFBDDBDBDHDBBHDBBBHDHHFBBBBFDHDDBBFHDFHBBDHBFHHBHFBFDDFDFFFHHBDDBBFFHHDHH
MightyMare14	BDHBBDDHDFDBDFDDDDDHHFHBFHHHHBDHHHFFFHHBHFDBFHHFBDHFHDHBBBBHHFBFFDBFFDDHHBHFBDDDDBBDBDFHHHFFFFBBBHFHFBFFBBBDFBDBBFFHDDFBHFBHDFDBHFHFHDDBBHDDHDHHFBHDBBBHHBFHBHDDBBDHDHFBBBFFHDDHFDBHDBFFHBDBDDHDDBDFBBBD
GallopingGalloper35	FHFHFFHFHHBBFHFDFDFHHBDHHFFHBHHBFBBHHBFDDHDHFHHFBFBHBBFHDFDHDHDDHBFDHBFBFBDBFBFDDDDDHBHHFFFHDBHFDFHBHFDDFDHHFBDDBHFBDDFFBDHBHHDFDBDBHHDBDDBFDHHFBBBBHFFDDDFHDBBBBBHDFBHFFFDDHHHBBBHFDBBFDHBBBFBDBFHHHDBH
HungryHoof32	BHDDFBBFBFHHFHBDFDBBDFBFFFHHDFBFHHHFFFFHBDBBDBDDDBFHDDBHDHHHHDFHBDBDHBDBFBHDDDFHBDDHDBHHHDDBFBDHDHFFBHDHHBDFDBFBBBDHFDBHBDHBHFHFDHDDFFDHDDFHBFDFFBDBBDDBFHBHDFBHDBFFDBFBDFFBDBBHFDFFHHBFBBDFFDHBBHBHBDBH
GallopingSteed91	BDDDFDBBFBDFFBFFHBFBHHHDFFHDFHHBFBHFHFFFBBDBBFBDFDFBHDFBBFDDBDBBDHFFDHDFFBBFBBBFDBHHBFDDFHHHHHFHFFBHHBHHDFFBBFHFBHFHFHFBHDHDFDFHFDBHBFDHBFFBHHFBBHBBHDDHFHBBHFDFDHHDFBDBBHHHBHFBDBFHDFFHFBFBHHBHBDFHHBHB
SneakyPony6	DHHBFFHHHFBHHDFDFHDDBHBDFFHHDHBDBHDFFHFFBHHHDDHDFDBHDDBFHDFFDBBBDFDBBDFDBHFHDFFHFHDDFHHFDDHDDBBFDDBBDBDBDBFHHHHDHFFHHFFBHHFBBBDDHBHBDHFBHFHHFFHFFBFFBDFHFHBHFDFHDDFDHDBHHHFHHFBFDDFFBHBHBBBHDDDDHDHDFBBD
SwiftGalloper71	DHHHFFFDHDBBFBFBFBDDBDBDHDBDFDDHDFDHFHDBDFFDBDHDFHFFFBDHBBBBFFHDFBBFFDBHFHHFBHDHDFFFBBHHHBDDBDDDFHFBBHHDBFHFBFHBBFFHHBFDFBDDBFBBDBBBFFBFFDDBHDBHDFBBDFFHBDBFHHBBFFBBHBDBFBFHDFFHHFFHBFBHFFDFDFDBDBBDFFFD
MightySteed50	HBHHBDBDDBHFFFBHFDBDFHHFDHFDBFDFDBFBDBDFBDBHFFFHBHFHHHHHDHFBDFDDFBFFHDFDDHBHFDFFBFHBDHDDHHHFHHDBBDDBFHFDHDDHFHHHHBFBHDBDDBFBDFDFDHDBFFFFBHBHHFHBFBFBFBBFDDDFDDBBFDBFFBHDDFFHFBHHHDBFFFBBHDFDDBHDDDFBFBDD
MightyPony25	DHDHHDFFHBHHHDHDHDFFDBFBFBDFFHHDHBFHFHBFDDHBBDHDFDDBFBBHDHFBDFHFFDDHFBDHHHFDFFDDDHHDFHDHBFDFDBHHFHHBFDDFDDFDHFFDHBHDBDDBHBBBDFBFHBFDFBBBBBDDBHFDFDBFDHDHFHHFFHHHDHHBHDBFDHDHBFDFBFDBFHDFFDHDBHDBFDFBBDBD
SwiftSteed16	HDHHHFBBBDFHFHHFBFBHDDHFBHBHHBBHHHBBHHFDDHFFHDHDBHDHBDFHFFDBFBDDBBDBBBBDBHHFDHFDDHBHFHHBBBHFHFFBBDHBBFDFBHDFFDHFBBFHHFDFDHBDFFHHFFHBHBHHDDBBBHBBBHHHFDBBBBHDFFHFFHBBHBHFFHFBDHBBBFBHHFHFHFHDBHBFDHBDFHDD
CharmingMane70	DBFBBHHDDHBHHBBFBDBDFHHDBBHBDHFHFDHFFDFHHBDBDBBFHBDFBHBFDDBDBDFHBFFDBDHHBFFFDHFFBDFBDFDBDFDFBFBHDBBFDFHDFFDFHHHDFHBDBDFDDDHDDHDDBHBHBBFHFHBHFDHDHFBHHBBBHDFHFHBBDBFHDDDBHFDDHHFFBDHDBDBBFFFHHFFDDDHBDDFD
CharmingTail37	FDDFBDBBFDDHDDBBBFFDHFHFDHBFBFDDDHFDBDFHHBHFHDDBHBFBHDHBDHHBFFBDFDFFFBFHHDHBFFBFHDFHFHDDFDFHHHFDBBFBFFHFDDFHFHFDHDBHFDDDHBFHFBDDFFHBBBDHBFHFBHBFBFHDBHHBFFDFHDHDBFHHHDDDDDDBDHHDBHBHDFDDHHHFFFBFBHBBBBBH
FuriousWhinny13	HDFFBHHFDFFBHHHFHDHBFBDFHHBHBFDDDHBBFFFHDBBDFFHHBDFHBDFHFHFBDDDFFBFFFBHDFHFBFHHFFFFBHFHBHDBFFDBFBHFBBDHHHBHHFDFDHFDFBBDFDHDBFHHFBHHFDDBFFFBHFBFBHDFBFHHHDHFHBBBDHBFBHFDDBFFFDBFBHBDDBDHHFHHHFBDBBBDDHBDF
DapperSteed39	FDDDDHDBBDHHHBDDHDBFFHHFFHHDFDBDBDBFDHBBFFBFFBHFFDFDDDDBDFDDFHHDDHBBFDDDBHFFDFDBDDFFDFBDHBFHDHBHDFHFHDFHHHBHFBBBFHDFFFBHDDFBFFFFFDHHDDFFDHFHFDHFBHFHBHDBBDFBFFFDBFDBFHFHFBDFHBBFFDDHBBBBBHBBBBFDBBHHBFHD
GallopingTail86	FFBBDHDHDBBDDFFBFHHDFHBDFBDHDDBHDBDDDHHDFFHDDHFDFFDFHBFDHDHDBBFBBBFBBBDDDDHFDHFBBDBDDFDFFHFBBBBBDBFDDBHHFBFDBFBFDFHHBDFFFHFBFFBDFHHDDFDHBHFHHBHFFBBDHHBHBBHFDBDDFHFDDDBBHBBBDHHBBBDDBFFHDBBDBFHBDDDDFDHD
GallopingMane22	FHBHHDBFBDBHHHFBDBDHHHBDDFHFHFDDDHDBHHFFBBHDHBHDBHFDFDBDHFFHFDFFBBDFFFHFBDHBBHBBHHHFHHDFFFFHBFDHBBFBHFFDHDBFDHHBDHBFFBHHBHDFBFBBHDDFBHFBBFDDDBFHBFHHDDHBBFFBDFDFHBDFHFHBBFDFBFBFBBHFBDDBBHFBBBBBBDHBFDDB
LazyHoof55	DDHDFBDFFBFHHHDBBFBBBDHHFHHHBFDBBDFHDDDHBFFBFHBDFBFFBHDDBHFBFFBFBFHHFHFHFBHBBDFDFHHBHFHHDFFHBDHFDDBDHFFFFBDHFDDDDBFFHDHBFHBDBBHFDHFBDDBHFDDHDFDBFBHBDDHFFFDDHBFBBHDBDBFHDHBBHBDBDHFHBBFDBHHDHBFBBDFFFDFB
FuriousTrotter31	BFHFDHBFBHBFHDHBFDFHDDFHBHFHDHHFHBBFFDDHHFFHDHFDBFDHDFDFDDDBDFHDBHFFBHDFBBDHFDHFDBDFHBFDHHHFFFBBHFFDHHFHHFBHHBFBBHBFFFHBFDBHDDHHDDDFFHDFBFHHHBHBHBHFHDFFDHFHFDDFDDHHFDFFBHBFDFBDHHFBFFBDHHBFBFFFHDDHBBHH
SwiftTail49	BDHFHBFHHDDDBHHDBHHFFDFBBHFBFHDDBFHBDBBHDDHDBDBBHBDFFFBHBDBHFDHDBDFBBFDFDHDHDFHHHHDHHBHBFFFHHBDBHDHHBDFHFFHDBBBDBFFBDHDHDHHDDFBFHDBFFBDBHDFDHFHHBBFBDFDHDHFDFFHFDFHBHDHHFBBBFFFFFHFBBDBHBFDHDFFFBHHHDBFF
PrancingSteed55	FFDHBHFFDBFHHDBBDDFHDFFFFFDFDDDDDHHBDFFHFDFBDHFHBBDBBFBFFBHFBBBDFFHBFDHDBDFDFFFDHDHHFHFHDFDFHHDFHBFDFBFFDBBFFDDFDDHHBFFBBHHBHHBFHFBDHHHDHFHFFBBDDFDHDDFBFDDDDBFHHBFDBFBFHBHHHFFHDBBBHHFBHBFFDHBFHFHHFHBH
CharmingWhinny66	BFBBBBFDHHFDDFHBHFDFFHBHDHFBHFHFBFFBBHDBDHDHHBHDHHBFFDFHBDDHFDFDFBDBFDFHHDDFDBHFBDDFDHBHHBFBFDHFFHDHBDBHHFDBHDBFHFFBBDHBFBBBHDFBFBBFBDFFDFHHDBBBFFDFHHDBDHHBBFHFBHBBDHHDFDDBBBHDHFFFHHHDFDHFDDDDDFHDDBFF
CharmingTrotter20	BBDBBDHHDDBDHHDDDDBHHHFFFBBFBBHHHBHHHDFDHFBHHHDBHHDFHDBBDDHDHDDDHDDHBFBFFDHDHFDBDFHFFBBFHFDBHFFFDHHBHFDFFBBBBDDDFFDHFDHFBHHBBBBBHFDFHFBHDFFHFFDDDFDHBHDBFHFHHBFHFHHDFBBBBDBDFDHFDFBFFBDBDBFHDDBBBFDDBHBB
MightyWhinny62	DDBHHHHDBHBDHDFDDFDBDFDFBHBHBHFBBHDDDFBFHBDDHHHFHDFHHFDBDDFHFDBFFBBHDHFBHBHHFDHDBDBHHFHHBDBDBFHBFDHHDDBBHHHHHDBFBHFFFFBBFFFFBBFBBBBDHFFDDBDBFDHDBBHFFHBFHFHDDHDDHFFHFFDBFDDFBHDHDBBBBDBHDBBFHHFDDHHBHBHB
LazyGalloper75	HFDFFBDDDHDHDHBBDBHBDFHDBBBDFDBBHFDHDDDHDHBFHDBFHHDBFFBFHHFBDDHHFDHDBBFDBHHDFBFBFHBHHHDDFHHDHHFHDHDHFFBBDFDHDBHHHDDDFFHHBFHFHHFHBHDDFFBBHBHFHDFBFFBBDBFDFFFFBFFHFDDDDFBHFFHBDHBHBBDDFFFFDDFBDBFDBBFDFHFH
CharmingWhinny63	DDHFFFHBBDDDDFHDFFFFFHBBFBBFHHDFBFHHHDBBDDDBFBHBHBDDBHFHDDBDDBFBFBHFBDBBFBFHFFDHFFBDDBDFFHBFBHHDDBDFBHBDDHFFBFDBDDDBHHDDHFFDFFHBBHDHBBHFFFFBDFDHDFHFFFBDFHFDFHFFBHFHBFHDDDFDDHBHDFBDDFDDDBBDBDHBHFBDFHBD
DapperMare77	HBDHBDBBHBDHBBDDHDBFHBHFDBDFDBFHHFBHDDFDBHDBDDBFFBDDHDHHHBBFDHFDHFHDFBDFFHHBDFFFDFHHBHBHBDBBHDHDFHBFDBBHHBDDDDHBFFFHBFBBHHDFDBDFHBBDBFDHBDBBDBFHDBBBFFHFHFDFHDDFHBFFDHFHDDBHHBFHDHBBFDHHDBDDFBDBFDFBFHDD
SneakyPony92	DBHHHHBHDDFDHBFBHBDHFDDBHBBDHHBBBBFFFDBFFDFDDFFBHBHBDFFBFFHHHDHBBFBBHBHHFFHFFBFBBHBBBBDDDHFDFHHBBDHBDDFDBFHDHBBFDBDHDBBHDBBHDBFHDBHBFDDDFBHDHFFDFFBBBBHBHFBBFHBFBFBBHHHFBHFHFBFFDFBBFDFHHFBHBHBBDFBDHFHH
CharmingHoof74	FBBHHBDHHDFHDDDFFBBDBDHDFFDDBBBDFDBBDBDFBDDDHBBHFHBDFFFFFBBFBBBBDFDHHFBDHHHBFFFFFBDDBFHHDHBDHFBBDDBFDHBBHDDDDFDFDHFFFHFFFFDDDDDFBBBFFBDFHDFFHFBDBDDDHBDHFDDHDFHBDBHDDDDDFFHBFBBFBHHBFFBDDBHFBDDBHDHHDHBB
DapperGalloper23	DFHDBHBDBBFDBHDDDHHHFHHDBBBFFDFHHDHFHHDFHBBHDFBBFDHFHDFBBHDFDHDDBHHFFDFFFFFBFFBDHDFDDHFFBHHFBDBHDDFBFBDFBFBFFDHFFBBDBBFDFHFFFHFBBDHDHDDBDHFHFDDBDFBFDFHBDFBBBFHBDDDFHBBHDFDHDHFDDBBHHFDBHHFFBFBBHFHDFFFH
HungryMane36	HHFHHHBDFDHDHFDDHHDBDBFDHBBFFFBDDDFFFFBHBDBHHBFHBBDBDFHBFFBHHDFFBDBFHFHDFDFFBHDFDBHDBDDDDDHFBBFBBFHBHDBBBBDHHFHFHDFFDDBDFHFBHDDHDHBDBFDFFBFDBHBBDFHFHHHDDFBFDFDFBBDHBBDHHDFDHHHDHBHFDFFDHBDFBBDDDDFDFHHB
LazyPony92	BFDBDHFHHFDHHBHBDHDFBBFBBBDBDFDBHDFHHFDHHDBBDBBFHFDHBHBFFBDFFDHDFFFDDBBHFDDHBDFHHFHDBDBBBDDBDDHDFHDFDDFBFHHFDHBFFFHFBDBHBDBDHHFBDBFDBHDDDHFBHBBDBFFHHFBBHFFDDHDBBBDHDFHFDDDFBFFBFBFHBFHFHHDBFDBDBDFBFDHH
CharmingHoof13	HHFBDHDHDDBHFBDFFDBBHHHHDBDFBBBHHBDHBBFDDBBBDDBFHFHDFFBHFDFFDBFHHBBDDBBDHBBDFDFDDDHBBFDDDDBDFDDBFBFFBDFFHFHDDBDBFHFDHFHHBBHFDDDFHFBBBHHHBDDBBDBDHHFDDDHBDBDBFBHDBDBHDFDBFHDHFFHBBDFBDFDBFFBDDHDDDDBHFDBF
GallopingColt74	FDFDHBDDFDHHBHDFHFFHHHDFHHFHDDFFHBBHFHFBBHFBFHDDDDFHDBHHBFFDBBDDFDFBFDBHBFFHFDBFHFBBHBFBDBFHFFBBDHBBDBDHBDBFFHFBHFBFDHBHDDDHDFFHBFHHBFHFDHDBFDDDDBBFHFFDHDFDHHHHFFFBBDBFFBDHFHBFHBFHHBFBBBFHFFBHDHBHFFHF
GallopingWhinny92	HBDDFHBHDBDBFFDFHDDHFFFFHHHBBBDBHHDFFBDFBBFDBFDBFFBBDFDBFHFFFDHFFDFFDDBHDFFDHFHDDBDBBDDFFHDBHFFHHBFDFBFFHFDHBHFFDDFDHBBBDFDFBBDHBFBDDDFDFDBHFFBFDHFHBDDFBDFBBHBBBHBDDDBHDBHHDHBHBBHFDDHDFHHBFDBBBBDDHBHD
FuriousSteed57	FBBBHBHHHHBHHDFHDBHDDDFDDDBFFHHHDFBBFDHHFDDHBBDDHFFDFDFHBFHDDHFHBFHDHBDBHBBDFBFDDHFBBDBHDBFDHHBBHFBHFFBBFFDHBFDDHBDFFDDDDDBDDDHDHFHHHFBBHHDBBBBBFHBFFHFHBFBDBBDDBFFHBHBDBFFHDHBFBHFBDHDDHBBDFDDHFBHDHHFD
HungrySteed24	HDBDFFBDDHFFHBBFDFDFBDFHBBFHDBFFDBHBHHFBBDBHHFDHDBDHDDBBFFBHHBBHBFDFFFBBBFBBBDBFDBFFDDHHDHDHDBBDFHBBDBHHBBHHDHDDHFBFHHBHDDHDHBHDFHDHHBFBHBHBBHHDDDBHFHFBDDFBFBFHFFFBBBHFBFFDBHHFDHDBBFFFFFBBDDDFFFDFBBFF
DapperTail98	FDFBHFDDFFHDBHBFHHFBBFHDDFHBHFBBHFBDFBBBDHHHDDBDFHHDHFFDHDBBBHHDHBHDFDBDDHBBBBBDDDFDHFBFBDBBFBHHFDBHHBBHDBFFFHHBHDDDDDDHBBDHFHDBDBDDDDHDBBHHHFHHDDFFFHBBBHHFHDBFDBHHDDDHBFFHDBHBFDHBBFDDDDBBDHFBBDBBDDBF
PrancingTrotter95	BDBDBHFFFDDBFHFHFDBBHFHFBFHFDBFHHBHHFBHHFDDBHFHFFDDFFHBHHDHBDFBBBBHFDFDDFDDDDFHHDFBHFFFBBFFBBFDHDBHHDFDBBDBHBBHDBFBBBHFBBFHBBHFFBFFBBBBHDDHBDHDDDBFHFHFBFHFFDFHHFDFHHFHBBHDFBBFBBHBBBFBBDDBDBFHDHHBFHDBD
PrancingTrotter42	BBBBHDBDFFBHDDHHDHHHDBDBDHFHHFDHDHDHFBBHDFFHHHDHFFDBBHFFDDFHDBBFBFFFDHHDFDBFHBBDHFBBFDFDBDBBDFBDHDFDFFBBBHBFFDFBBHDFFBBBDFBFBDBHHFFHDHHHFHDBDFHHFHHDHHDDFHBBHHDFHBBFBFBDBHDBFBFBHBBFHHHFFHFHHHHBHFDDFBFF
MightyMare40	BFDDBHBBBFHDHBFFFDFDBFFDHHBBDHBBHDBDFFBFBFBHHDFBHBBBHDFHFHBHHHHBBHBHBFFHFFFHBBBBFBBFDBHHBFBBBBBDHHFDFFBHFDBBBFHHFDBFBFFFFBBBFDFBBHDHBHHBBFBBFFFDFBHBFDDFFHBDFBFBBHDHFHBBBHFDDDDFFDHFFBHBDFBBHFHDBFHFDBBB
PrancingSteed2	BFBFDHHBHDFFBFBHDBDBFDDFHBFFHBDDBHFFBDBDDHHFBFFBFHBHFDHHHHHFHHBDBFDHDDFBHHDBDDBBHFDFFDBDBHDDHHFBDHBHHBFHDBHDHDFFFBDFFFBFDHFHFDBBFBFDFFBHHBFDBFFBDDHBBHFDBHDBBBFHDFDDBDFHDBFDFBHHFFHHHBFHFDFDBHBHFBBBHFFF
HungryWhinny56	BDBHFHFHHFBFBFDFHHFFHFFDFBBBDDDBFHHHDBFBHDBBDBFBDHDFHBFHDDHFHBHBHFFHHHHFHHDHFFHHDBBFBDFDDBHBDBHFHHDDFBBHBBFFDFBBFHBFBBFBDHFFFBBFBFDBDDHBDFFHFBHDDHBFDHBBFDHBHFBDBHFFDFBFDDFDFFDHDBFDHBDDBBDHDHBFDBDHHFFD
FuriousTail74	HHHBBDBBHDHDDBFHDDDFFDBBFHHHFDHBFDHBDBFDDDDHHHDDHFDBDDDDFHFDDDHHDFHHHDBBFDDHBDHHDBFDFDBFDDFDHBDBFHHBHFFDDBDFHBDDDDHHHHBDDBBHFDHBHFBBFDHBDBFDBHHFFFHDFDFHDDDDHBFDFDFHFDFFDBFFFFHDBBHHBFDDFHDBFHBDFHDFHBBB
SneakyWhinny78	DHHBDDFFHBHDBBBHDDHBDHFHBDBBHHHHFBDBFHBHHFBDDDFHBBFHHBBDHFBBFHFDBHBFHHFBDDDFBHBBFHBHDDBBDBFHFFBBHBFBFHFFDFDDFDDBDBDBDFBHDFHHDHHHDHDBBDBFHBHDDHFHFBBBBHBFHBHDHBBBFBDFDBHDHBFBHBBFDDFFDDHBDDDDHDDDDFBBBFBD
LazyMane48	FBBHFDFBBHHDHFBFHFBFBHDDDHDFFHHHFBFHBBBBHHHHBFHFFHBDBHHDHHHBBFBFHFBDDFFBHBHDFDFFBBBBHHFHDHBDHFDBDFBDHBHBHBBBHHHFDHHDHHBBDFFHFHHFBHBBBHHDDHFHHHFHBBDDFFBFDFBDHBHDHFFFBDHDBDFDFBDDFDDHFDDFDBBDFHBDHHBDDHHD
HungryMare28	BFBHHDHBFHBFHDBHHBDDFHHBBDDHFDBHHFHFDDBHHBHDBHBBFHHFHBBHBFDBFHFHHDDBDFFHBFFBDBFDFBHBHHHDBBDHBDFBFDHBBDFFDFFDHDBFHHHHFHHFHHHHFDDBHHDHBBFFDHHFHDDDHDFBFBBBBFFFHFDBFDDFBFHHHDBHBBFBDBBHHHFBDHHHHBFHDBBFBFBF
MightyColt42	DDHBHBDDHHDFDDFDBFFBDHFDHDDDDFFDDDBDFHDBHFBHFFDFHHDFBHFHHBFDBFDDDHFBFHFDDDBFHHDBBDBDDFFHFHHHBFDBDFBBDHBBHDDHDFHFDDHFHBFHBFBHBFHFFBDBFHBFBHHHDBFBDBBBBBHDBHHHDHFBBHDHBBDBDHHHHHBDHDFFHHDBDHBHHDFHDBDDFFBF
HungryTrotter89	FFHBDBBHBFBBBDBDDBDHBDDHDHHBFDFDBFHDHDHDDBBFFHHFDDHHFDDBDBBFHFBHBDBBBDHFHDBHBFHHHBFHHFBDBDHDFFDDBHFBBDDFFBHDHDHDFBDBHHHFFFBFHHHFHFDDBDBDFBFFHDHDDHBHDDDBDHHDDBFBDFDFBHFFDFBBDBFFFBHBFBBBHFBFHDHDHBFHDDHB
SwiftWhinny12	HFDDBFHFDBBDDDDDHFDDBHDFHHDHHDFFBBDFFBDFBHFHBBBFBBDDHHDHFBFHFHFDDHFDDDFDHHDDDBFDHDBHFFHHFDDFDFDBBBBHHFBHHFFHFBFDHDFBFHBHBFDFDHFFDDBHHBDBHHHHBFDFBFFDBHDHFHHDBFFHHHFDFDFDFBHHHHFBFHDHDDDHHBBHHBBDHBHFDBBD
GallopingHoof96	FBFFBBBDBDDFFBHFDBHFFHHDHFFHFBDBFHHHDHBDDBDHBFBHFBBHFDDDDDBBFFBFDBFDFHFBHHDFHHHDBDHDHBBBBHHHFDDBHDBFFFDFDDFHHBBHBBDHDFDBHBFFFFFHBHFFDHHBDFHDHHBDDBBHBHDHHHBDBFHFBHFFBBFDHFBDDFBDBHHBDFHBFBDBHHDFDDBDBDDB
CharmingMane5	HBBFFBFFBDFBFBDBDFBFFDDBDDFBHFHFHDDHBBBDFFHHFHDDBBDBBHFFBDFFDBFDFBBHFFDDHDHDHHFDDDFFDDBBBHFDHFHFBHFHDDFHFHDFDHFFDFHDBBFBBFBHDHBDFHFBDHDDDFDBBFDBBDHBDBHFHFDFBBBBDFHHBFFDHBDFDDHDFHDDDFHFFFHDDFDBDHBFDDFB
GallopingHoof85	BBHDFDBFFDBDHHBDBDBDBHBHFDFDHFDFHDHHHDHBBDBDHHFDFDFDDBBDFFBBBDFHDFDFHFFFBHDHDBBHBHFDFHHFBDHDDDFDDDHFHHDBFBFBDBHFHDBBHFDHFHHDHFFDHBDHBBBHHBBBHDFFDHHBFDDDDBFBDFDHHHBDBFHFDHHHFHHHDBBDFHBDBDHBHDBHDDFHHHHB
DapperTrotter65	DHHBFHFHHBBBBBHDHDHBBBBDDBHDBDHFDFDHBHFHBDDDHFBDFBHDFHHFDDDBDBFFHHDFHHBFFFDDFDFDHHBBHHFDHBBFBHBHBFFBFHHDHBBDBHHHHDFBHDBFBDHHDDBFBBDDBDFDHFBFDDDDFFFDHFBHFBDBHHFBHBHHDDDBHHHDDDHFHFBBBHHBHHFBDHHFBBBDBBHH
FuriousWhinny32	HDHHBFHHFFFFDHFDDDHDFBHBHDFFBDFHDDFHDHHFHBHFDHDFBDBFHBFBBHHFBBBFBDHDBFBFDHHBHBFDHBFFDFDFFBFFFHHDDBFBBHBBDHBHBHBHFHFFBFBDBHHFFFDBHBHHHFBHDFDFHDHBHFDDBDFHHDBBHFHFBBFBBHFHBBFHHBBBFDFHBFFDFBFDBDDBFFHDBFBD
SneakyHoof29	HBDHDFBHFHHFHDHFFHHFDBHDDDHHBHHHHFBHFHFFBDDDBDHBHHFHHBDBDDBBHBFDBFBHHDFBFBDFHFFFDDHHDDFBDDHFFDDBBBFHDBHBFHHHBFBFBFHHBBBFBFDHBDHFHBDBDDHHHDHFDBDDFFBFDBHBFDBFHBDDHDFBFDHBHFDBDBHBBBDFHHBBFDBFDHHHBBHBBDHD
LazyPony89	DDBDDBFDFDFHDFDFHFDDFDBBBHDFFBBFDHFDBHFHFFFHBBFDHFDDHDBDBFFFHFBFBHBHHBBDDFHFHHFFFBBBDFDBHDDHFDHDDFHHHBFHHHBDFHFHFHHHFHHHBDBFFBFHHBBDHHDDDHHHFFDFHHDBDHBBDFBHHDDBHDBFDDFDBFDFHFHHHBFHBDFHDFFHDDFFFFDDBHHD
LazySteed24	BHBHHBFBHHHBFHFDBDBBHDHHDFBFHDFBBHHFFHDFFDBBFBBBDFHHFHFHFHFDHBFDFHFHHDDHHBDBBDBDHBFFFFDBBBHHFHDBDFBBBHFDDBFFBBFDHBDBHFBBDBHHHFFDHFFHDHBBFDHBBBHDDBDBFDDHDFFDDDBBHFHHFHBHDBFDFDHHHFDFHBFFHBDDBBFDFHFBDHHF
GallopingHoof71	HBBDFDDDDFHFFBHBFHFBFHFHFBFDBBBDBBBHDDDDDHDBFFBHBFDHHHHFHFBHHDDDFBDHFDBFBDDBDHFHHFDDDBBFHDDHFBHDFBFDDHHBBDHFDDHBFBHDHFDHDHBFFFBDBDDFHHDFBFHFHBDDHBDHFDBHDBHFBBDFDFHBDDHDDHDDHBHHDDDDDFDFDBBBFBHBDDHHBFDD
SwiftPony94	FFFBBHHDHDBDHBDBHHFFFDBHHFFHHBBHFFBFDFFBFDFHBBHBDFFBHFDDBHHHDBFBDBHHFDFFHDFBDFFHFHHDBDBDDDHBBDDBHHHHBHDDHBFHHDDFBHBDDHBHDHHFHHHFBHBFHDDBBBHDFDFBHFBDFDBDDHHDDFFDFHFDFBFFFHBDBDBBDHDFDHHBBFBDFBHDBBBBHFDB
SneakyColt54	BBDBHFDFDDFDHFDDDFDFFFFBBBDFDBBFBFDHBFDFDDDDBFDHDDBFBFDHFDBDDFFBBHBHFBFDFDFDDDDFDDHDHBDFBBBFHBHBFHDHHFBFDHHHBHDFHBHDBDFDFFDDHDBDBHDHDFHHDFBDFDBDHDBBFDBHFFDHFFFBFFDHFFDHBHBHBFDDDHFHFHHBFFFDDDDDFFDDBFDD
FuriousWhinny51	FBHFDDFHBFBDDDBFHFFFBDFDDFBBHHHFBDFHFBDBFHHBBDFDHBHHDFBDBFBHBBDDDHBHBDBFDHFDFHHFDHFFFHDHBDBHHDHHBBHHBHBFDDBBBFDFDHHBFBFFFFHFFBHBDHFDDDDFBDDHFDBHHFHDFHDFDHDDBHHFBFHBFBHDDBDFBBBDBFFHHFFFDHFBFDFFBHFDHBFH
LazyMane18	FDBDDHHDBBBBBDHFFDFHBDBDFBDBDFHDDHHBBFDBHFHBFBFHHFHBFFDHFBHBFHBDFDBFBHFDHFFFDBDDDBHBHDHBBBFDFBDBBHBFHHBDBHFBHFDHDBDFBFBDBHHDBDFBDBHBFHBDFDFHHHBBBFHDBHDHFHBBFHHDHFBFDFFDFDBDBHFHDDFDDFHFDHHHFBDFDHHFFBBF
HungryGalloper52	DHFDHHFDBFFDHFFBDBFFBBDDHBDDDDDFDFDHHHHBBDFHBBFFFHFBFHBDHFDBHHBHFHHHHBFFDDDHBBHDHFHFFBBFFBHDBHHDDFHBBFDBFBDDBDHDHDDBBHHDDFHDFBHFBHHDFHHFHFBBBFDHHBFHDHBBHBFFDBHBBHBHBBDFHHBDHBHDBHHFFFHDBFDHFDHHBBDDDFFF
LazyTrotter35	HBBFHHHFDBFFDFHHHFDFBFDBBFDDDHDDBBFBBFHDHDHFHDBBHDDFHFDHDFHFHHDFFDFBFBBHHHHBBHFBFHDHDDFHFFDHHHBDHFFBHFBBBDHDBFHHDBHHDDBFBBFHFBDBBDDFFFHFFBBFBBFHFBDHDHHDHFHFHFBHHFDHHHDFHHDHBBHHHBHHDFHHHFHHFDBBBDFFDFFH
CharmingMare58	FDFDDHHBFHDBHHDFFHBHFDHDBHFDHHFFDHHBBHDFHDHFHHBHFFHBDBBBDHDHBFHDFBHFHBDHFDFBDDBHHHBBBDHFHFBHDHHDFHFHFFBDHFBBDFFBBFBDBFHDFDHBHDFHHDHDDHDDHDHBHFBBHDBFDFFFHBBBHHDBHBBHHHHDFBDDBDFDBDFDBBHFBHBDBDDFHFBHDHBB
SwiftTrotter69	FHDDBBFFBHDDDHBDDHFFFHBHHDDDBHHDDHFBBBHHBDHDBFHHHDDDDDFHFDFDBBFBFDDFDHBDHFHFHHHFHFHDHHBFDBHBFBHHHDBHFHDHDBDDHBFHHBBBDFFHHBFHFBBBDBBBDFDDHHDFFBFBFDFBBBBHBDBDBBBDHBBFHFDDBBFDFFFFBHHBHHDBBBHFFFBHBFHDHBFB
DapperColt37	DBBBBFDBDBHHHBDDDBDBDDBDHHFDDDFDDHFFFBDFFHBDDBDFDDDBBDDFDBHBBHDHFHBHHBBFBHDDFBBBFHDDHFBBBBFBHDBDDFBBHHHFFHBFDHHFHFFDFFBHBDHHBDFHDHFBFDFBFBBBBFFDDDBBHDFFBFBHHBDFHHBDFHBHFHFFBHHDFFFHHFBFHFBBDHBBHDFFFHFB
SwiftMane80	FBDBHDBDBFHFBBDBHHDFDDHBFHDDDBDDDBHDBFHFDHFDFBFBDFHBBDBFBHFBFDHFDDDBDFFHFBHDBBDDBFHFDBDDDFBHHFHFHDDDHDBFHFDDFFFDHFHDBBFBBFHBDHFBBFBHHDFFFBFDFBDBDHDDDFFBHFDHBDFBDDDBBHDBHFHBDDDDHBHFFBDDDHFHBFBDBFBDFDHD
GallopingMane83	DDDBFFFDHBFDBHFFDHHFBHDBHHBDFBHDFHHHBDFFBHDDFDBHBDDBFDDHDHHDHFDBFBFBDHBHBHHFBDFHFHBDFBBHBHBDBDDBFHFFDFFBBHBFBBFFHBDDBBDHHFHHDDFFHHHHBDFFHDDBHBBHDFDFBHBHBDHDDBHHBBFFHHDDFFBHHHHFBDDDFFBBFDFHFDDDFFHDBBBB
HungryGalloper42	FFHHFHFDDDHHHDHBBBBHDBFHBFBFBBHDHBHFFDHFBFBFDBHHHHDFBDHFFBDBDBDHFFFBFBFBBFDFDBHBDBFFBHHHFDDFHBBFBFFHDFHHBDFHHDDDDHHDFFBFBFDFFBHBDDDFFDDDDBBBBDHDDDDDDFBHDBDFHHBFHBHFBBBBBHFHBFDBDDFHFDHDHFDFHBBDBDHFBHBF
SwiftSteed31	DDBFFFFFDFFFHFHFDBBBFFFFBDHFBDHBDDFDBFBBHDFFFFBBBFBFBFHDHBFFFFDHDBBFBBHBHFBBBDDBBDBFBHDFHFBFDDDDDHFDBBBHFHDDDFFDBBFDBFDBBBHFBDFHFDHHBBDBDHHHDHFDHFHFBBDFDDBHHDFHFHHFBFBDFHHHFBHHBDBBFBBDDFDDBHFFFHHBBHFB
SwiftGalloper93	HBBDDDDBBDDHFHBDBHFHBHFDFFBBDFBDFHHHFFHBDFFDBHHBDBHHFDDBBDHBDDDHFBHFHDDHDDBDDFFHHBBBBHFDHDDBHHDDFBHFHHBDHFFHBHBFHFFBFDHHBHFHFDDDDHDHFFHHFDDFDDBFDDDHHBHDDFFFBHHFHHDBDHBFBDBFFDFFFBBHHDHFHBFFDHFBDDDBFFFB
FuriousTrotter65	BBBBHFDDDDHBHBFBHDDBFBDHHHDDFDDHDHFHDDDHBDHBFHHBFBBDFDDFHHDFDBDHHFHBDBFDHBHFDHDDBFFBBFDHFFFFHFDFDHDFFHBFDDBBHDFBHHHFDDDHDFDFDDFDBHFHHFBFHDFFHBHFFHDBHDHDBDHHHFHFFHDHDDFBBBBDBFHDHBBBDHDDBHBHBDFFDFDHBHFH
PrancingMane62	BDBFDDHHFFBHFDFBDFHBBBHFHHDHHDBFFBDHFBHFFFHFHBFBFBBBFBHFDDFDFBBBDBDBBHFBFBDFFBDFHFBHDHFHDBDDFFFDBDFFFFFDBHDBFBDFHHBFHFDFDFDBFDFBFFBFDHHDFFFDBFFDDHBHFBHHBFFFBHHFDDFBBBFHFHHDDHDBHFDFFBBDBBBBHHFDDHBFHDFF
LazyWhinny52	DDDBFHDFDBHDFFDFDBFHDDBDBBBFHFHHFDDBFFHBDBHHFDBFHHBBHDHDBHBFBFDFHHHDHHHFDFBBFFFHHBFBHDHBDHFFHDFBDFBFHFBFBBBHHHFHDFFDHFDHHBBDFBDBBFDBBDFFDFHFHFDBDDFFBBBHBHHBHBHBDBFFHBFDDHBBFBHDDHHFHBFHFFFDFDDHDFHDBHBB
LazyColt75	DBDFBBDDHDFDHDFBBDFBFFHBFHHDFHHFBBHHFHBHBHBDDHFDHHHDDBBBDDHDHFDFHHBBBDFHDDFFDFDBHFFHFHFHFFHDDHHHFDHFBBHHFFFDDBDDDFHHHBHFHHFBHHHFBFHFDDFDFHHFFHHDFHHHHDDDBHHDFBBBBFBFFFBHDBDBBDHDDFFHBDBHBHBBHDHHFHFHHBHH
SneakyColt69	DFDHHFFFHHHDDFFFDBFDHFDDDHHBBDDBDDDHDHDDDHDFHFFBBHFHHDHFHDBFHBBBDBDHBFDFBFFBFHFFHHFHBDHHFHBBFBBBBDBHDFDFDHFFFBBDDHFDFFFHFDDHBBBFDDBFDBHHFBHHHHHHBHBBFFHFBDBFDFFHDBFDFBFBFFDFBBHHBDBHHFHFFDFBBDFHBDHBFDFB
CharmingGalloper10	DDFBFHBFDHFBFDHDHBBDFFDDDFBBDBFFHBFBFFBBHHDHFFFBBBFFDBBFHDBBFDBBFDDFHDFHFFBBBFDDFDHBFFBHFFBDDDDFHBHFDFDFDHFBHDFDHBDBHHBBHBDDDHDHFFDDBFFFHFBBBFHBHHDFDFBDHHBHHDBHHDBDFBFBDBHHBBBFFDBFHDBFFHBBHHBBFDDHFHHH
LazyGalloper67	DHFDFBHFFBHDBBDFFDFFBHHBHFBDFBDBBHHDBDDFFBHFHBBBFBBHHBHHDDBDDHHFHFFHFDBBDDBHBHFHHHHBFDHFBHDHBHBDFBDHDBDFBFDBFDFHHBBHDBHFFFBDHHFBDFBDBDBHHBDBBBFDHFDFHFBDFDFHBFFDBBDHHDBBBFFDFFBBBBBBHDDFBFFDFFDHHFHDDDBD
LazyGalloper93	DDDBFBHHDHHBBDHDBBBBHDDBHBHFDHFBFBBFDFBBFHBHBBDDBFFHHHFDBDHHDFHFHDBHDHHFDFHBDHHFDFBDDDFHDBBBFFFDBHDDFBDDBFHFDHHHFBFHDBBFFFHHHFHFDHFHBHBDHFDFFBFFDHFBHDFFHFDHDBHDFBBFHFFDBBFDDDDFHHFHDDHDBHHDHBFBHBHFFBDB
DapperMane76	DBFDDFHDBFHFHDBBDHBDBDDBFFFFBHDBFBHFHHBDBBHFDHHDDHBDHHHHDHFDBBFBFHHHFDHDBBBHFHBDDFDFBBHFFDBFHBBHBFFHBHBFBDFFDBHBHFHDHDBDBDDBFBDFDFDHFDBBFFFFBHFBFBDDDFHBHDBDFFDFDBDDDDFDHBFDBHDDHBDDFFHHFHDBDDBHBDDDDBDF
SwiftTrotter41	DDHDBDDDFBDHFDFHFDBHFFBHDDFBDDHDDDBHHHFBBBBDDFBHBFHDFBBFFFFDDDDDHFHDHHDBHDBDHHDDHHBFBHBFFDHBDHDDFFDDFBHBHDBFBDHHHBBDHDBDBFBBBHDBBHBDFDHDHBHHHBHDFBBDFBBDFFDHDBFDBHHDBFHBBDHDDBBFFHHHBBDFFDFDHFFFFFBBFDDF
GallopingSteed56	FBHBFBHFHFHFDBBFFHHHHDHDDBDHHBBBBFFDHDDBHHBFHHBBHBHFHDFFHFDDBFHHHHDBDDDFFFDHBDFDDBDFFBBFBFHFDFHBBDFDHFDHDFDHBBBHDDFHHFDBDFHBHHFHHBBHDFBHHDHDDFBDDFFBHDDBBBBBFBFDFFHDFHHHFBBBBBDBHFHHDFDDFBHDFHFDBDHFDDFB
CharmingColt31	DBHBHFHDDFDFHFDDBBDDBFFBBHBFHBFHFBFFFFBBHHBDBDFFDBHDBHFDBHBBBFBBFHHDBDBDFFHBHFHHFHFDHFFHFDHBHFFDDDBFBHBDBFBFHFBFHHDHDBFDFBHFHHHBFDBFFDFFHFHBDBHDFBDDHHHFBBBBDHDDFHFFBHFFDBHFDDDDBFBHHDDHHDHDDHBDBDFHDFDH
SwiftSteed60	DFBFDHBHHBBBHFFFBFBHDFFHDHHFHHFHHBFBFDBFHBBFFFBDHDFHBHBDDFDFBFBFHHFDBFBDFBDFHFHHHHBFFHHFBHHFDBBFBDDBBBDBFHBDHHFHBDFFHHBBFDHDHBHHBBBFDBFFDDFDFDHBDHHHFFHHBFBHHDBFHDBBBBDDFDFBDDBBHFDDBDBFDHHBFBFDDFFBBHDD
CharmingHoof46	FBBHFDDBBFDDBFFFDFBDHBBDHHFBDBDBBFDHHFHDBFDFDHBFHDBDHHHHHDHFFDHDHBBFFFDDBFHFHBDDBHHFFFHHHBBHHDHFFHDFDBBBBDFFHHDFFBHFBHDDFDFDBHHBBBDDDFBFDFDDFFBFHHFDDFFFFHHFBFDDDDDBHBFDDBBBFDHFFBBHFFHDFHDBDFDFBBHFBFBF
CharmingPony69	DBFHDHBHFBBDBBBDHBBFFBBBBDHFFHDFBBHDFHFBFHFDHFDDFBBFBDDFBFDDBHFFFHFBBBHBDDBDHFFDBFBBBDFDBHBDFHFDDBHBDBFHBFDDBBBFFBDBFHDDDDFDHDBBFFHHHHDHFHBDFDHFFFFBBFHHFFHHHHFHFFHDDFDDHHHHFDDHHHFFFFHFHFBBFHHFDDDFFHHD
CharmingSteed46	FFFDBBDFBDHHDDFHFFFHHHFHDDHFBBHDDFFDFBDHHDDBHDFDFBFBHDDBFBBBBFBFDFFFDDHFHFHDBHBDDDFDDBDFHFFHHDBFDHDBBBFFDHDDDHBBDFFFDFBDBDFHFDBFFFFHDHBHHFHDBDHBDDFBHBBBFBHBDDDHDBDDFDHHHBFBBHHHDBDBHHHBDBFBBFHFHDFFHBHD
FuriousHoof67	HFBDDHBFDBHHDFFHDFHDHFBDHFBBFHDHHDHHHHFDBFDDDFBFFDDBBHHBDDBHFHDBDFHDDFDHHBDDDDHDFDFBDDDDBHFBBHDDFBHHFFBFFDHDHBDHDBFFDBBFBFBDBBHDBFFFFBFBHFFFFFBHFDFFDDDDBFHHHDDHHHHDHFHFDFHFBDDBFFHDFHFFDDFHBHFBBBDDHBFD
MightySteed85	BFHBHDBHBFHFBBFBDDFBBBBDFDFBDDDBHBFFDDHHBBHBFHHDBHHBHDBFFHFDFDFBBDDHFHDFFBBBFHDBHFFDBHFDDFHHBBFDBDBHFDHDFDHHDHDHBHHHHDBFDDHHDFDHDDHDBHHFHFBBFDBDHDDFBDFDBDBHFDFHDBFFFHDDBDFDFDBDBHBFFDHHFBBFFFHFFBBDHFFF
HungryWhinny56	HFDHBHFBHHBBBDHDBDHDBHHDHFFDDHFHBDFFDDFHDFFFFDHFHHFHFDHHBHFFHHFDFDHDFBFHDDHDBHHBFDDFHDHFDBDDBFBBBBHDBBBDDDBBFBDDFDHBHDDHFHFHHFHDHDDHHFHFBFFHFHDBBBFDFHDBFBDFFBDFHFDFDFFHBHHDHDBBBFFDDFDDBHBDFDBBFBBDFDDH
GallopingSteed65	FDBDDDFHBDFBHBDDFBDFBBBHBHFHBBHHHHDDFBFFHDDBDHBBFDDDDFFHBBHFDDBDHFFBFHBFHDBBHFFFDHFBBHBHBBBFFHDHHFBBHBDFHBFHDHBFFHDDFHHFHDBHBFDHFHHFFBHBFHBBFFHBDHBDFBFHBFBBBFDBDFHBFBHFBDBHDHFHHHHHHFHFBBBDBFHBBHFDBDDD
DapperMane1	HBHDDFHHFFDFBHHFFBBFDHFHDHHHDDDBBBBBFDBDBDHDHHHHBBFBDBDBFBBBDBBFFFBFDBFDBDBFBFHDHDHFBBFBBFDDHBFHDHFDFFHBFBFFFFFDHFDBDBHHHFHHFFFBBFHHDDFFBDHHFFDHDHFBHBDBBFBFFFDBDHHHDHBBBDDBBFFHBHDFBBBBHHFHDFHDFDDFHBHD
CharmingTrotter30	HFDDFDFHHFHDHBFHBFHBHDDFHHDBBFBBDHFHBDBHFBHFBBDDHFFDHBBDHDBDHFBHBDFBDDBHHHBFBDDBFHBFHDDBFFHBFHDHHDHBHDHBBDDFDFBHFBHHHBDHBDBFDBBHBDHDHHDFDBHDBFHBBBHBBBFDFFFFFBBFDDDFFHHHBHBBBBBFBFBFFBHFDBHBHDBBFDHBDDFD
SneakyHoof8	DBDBFBBDFHDFDFFDFFDDDFBDDHFHFHHDFBBBFDDDHFFBBDFHBHBDHHHHHDDHFDHBBFBHFFDBHHDHFBHFHHHHFDFDBBBHDFBBFFFHDDBDBBFHDDFHDBFFFFDHBHDDBBFHDBBDHDHHBBFBDBBDBBDBDDDBFDHFHDFHDBHDHHHDDFDHBDBBHBBFDFDFHDDFHHFFBHHDDBDF
SneakySteed4	DFDBBHBDDDFHFDDBHBDDHBFHFHDHHHHBBFFHBBHBDBFBHDDDHBBHFHDDBBDFFBFHFHDFBDHDDHBHDDFDFHDBFBHHDDDDHBBFDDFFFFBHDBHBBFDHBDBHDBHHBFBFDBDBBDDHBDFHFFHDHDHBHDFBFBHBFBBFHDFDFBFBFDDDHFHHDHFFDHDFBBHFBBBFFBHDFHBFDHHH
MightyWhinny74	BHFHBFBDHBFDHHFDBFFDFHDBHBBBBBHDFFFBBFHDBDBFHBDFFDFHBHBHFFHDHHHHDDBDDFBDDDDBDHDFFFFFDFFFDDFFFFHHDBDHHFBHFBBFFDBFHHFDDDBDBDBDDHDBBBFHBHFDHDDHHDFFHDFFBBDBBHDHBHBDHBHBDFHDFHFDHDHDHDHDHFDHHBHDFHFBHFBFHDFB
SneakyGalloper11	HDBDBDHFBFHFHBHBBBBHDHHFFDHFDHBFBFBBBFBDDBHBBFFHHBHBFHHFBBFHBHDHHHBHHDDBDDBBHDDDFFDFBHHFBBFHFBFDBBHHBFHFDBFHFFFFFFFBBDFBFDDHBHDDHHBBHHDFHBBBDBFDDFDHBHBBBFHFHFBDHHDBDHFFBBBHHFBBBDDDHBHFDFDBFDHFDBBFBFDH
MightyTail26	DDFHFHHDBDHFBFHDBFFHHBHDDBFDBDBBDFDDFBBDBDFFHBHHDBBHDBBFFBBDBDHDDBBHDHBBDHDFDHHDDHBFFBBDHFFFDHFBHFHDFDBFFBHFHFHHHFHHHBDFDFBDDDHFFBHBFBHFHDBHBFDFBDBDBBFBFFBDBFBBBBDBHHFDHFDHFHFFHFBFHHBBDDHFHDDHBHDDBDBF
MightyTrotter69	FBHBBFFFHDFBBBFHBDBFBHHDBFFHFFHFFBBDBBHDBHFHDDFBFBDFFBBDHHHFFBDFDFDFFBFHHBBBFHDDFFDFBFBDBHHFHHHHDDHFDHBFHHFHBHFDFDDFDDFBFFHDBFBHFDHFFFBDFBBHFHBDHBDHHDBDDFDBHFFDHBHFDFBFDHBFHFFHBHDBDFBDBFFBBFHFFDHBHDFH
LazyGalloper74	BDFBDBHBDFBDDBBFHHFBBBDDHDBHFHFDFBBHFHDFHFHBFFHHHBBDFBFHDBHFDFBFFHHHDDBHHDHDFDBBDHBHDBDBFDHHBFDBBDHHFHHHBBFFDHBDHDBBDFBFHHBDBFFBHFFFFDBBDFFDHHHFFDHFFHFHDHFFHDDDBHDHHBDBFFBBBDFDHBHHDDBDDHDDBDBDFFHHBBBD
CharmingMane72	BFFHDHFDHDHFDFDBDHFBDHDBDHFDFDHDBBDDDBFFHFHBBBBDDHDBBBHHHBFHFHHFDHBBBBHFDHFBHDDHFBDFBBHDFDDBFBDHDBFDBDHFDHBBFHFFHBFDFDFDBDFBFBBDBFFHFFFFBFFBBHBDDHHBFFHDHDFHFHHDHBFBBBFHBHFFDBFHDHFFHHFDFBBBDBHBHFDBFFDD
LazyMare8	HBFHDFBDFDHBFBFBBBHDBHBDHBHFFBBHHHBHDHFBHHDHHDDBHDFDHDDBHBBHFDFHDFDFDHFBFBHBFFDBBDBBDFHHHBBBBHDHHHBDBFHDHFDBDFHHBHBFBHDFFFDDDDBHHBDHHBFFFBHHBBFFFBFHDBHFHBFHBHFHDBDDFHDFDFBBBHHBHFFDDHFHFHBHHBDHDBFFHFBF
GallopingSteed96	BHDBHHFFHDDHDFHDHFFHFFHFBDBFFBDDDFBFBDHBBDBDHDDBDHFDBBBDDFHHHBFFBFBBDFBFDFDDDDFDBBDBBHHFBDDBHBBFDHFBHDHHBDDBDFBHHHHBHFBBBFHHDDFHDDBHHBFBHDFBFFDHHFHBDDBFFDFBDFHFHDFFHFFHDBBDHHHHFBFFDDFBHHHBDFHHHBHHFFFB
PrancingHoof85	DBDFHHHDHDFHFDBBDDHHDHHBBBDBBFFDBHFFHBFFBHFFDBBDBHBHDHDFBFDDBHBBHBBDFHFBFBFHDHFFHFDDDDFFBDHDFHFDBFFBHHBBDDDFDBDDHDBHDBBBHDFFFDFDDHHBFHHFBHHHFHFHHHFFFHFFHHDDHFBBBDDHHHBBHFHHDDFFFHHDFDFBFHDFHBHBHBDDFFBH
SneakyMare23	HDDHBBFBHFBHDFFFBFHBDDHFFBHFHHHFDBDHDBFDFDFDBDBFBBHBDFFDFDBBDHHHBHHHDDFHHHDHFBDBDFBDFHHFDHHFDDBDFDFBBDBBFHFHBDDFDFHBDHFHFDDBFDHBHHHHFHDBHBDBHHFBDDDDFFHHBHBDDHDDFDFBDDFDBDFHFHBFHBDDDBHDBHHHHDFBBHDHHDFF
CharmingTrotter97	FHHFHHDDHBBFHBBHDFFFFFDDHDBBHBBDBFBFBHDBHFFDHFHFHHDFBDHBFDDBHFFHDFFBBBBBHBBHDBHDBDHDBDHDFFDHFFDFHFDBDFFBBFDBBDDFHFBBHDBFBDFDBHDFBHDBDHBFDBBBDDHFDHDHFDFHBHFHBDBFDFHBFHDFHBDFDHBDBDHHBDDFHBBDFFHBBDBDDFHH
MightyColt62	HFBFFHBDHBHBDDFBFFBHFHHBHBHBDBBDDHFBFHBBHBDDFDBFBDDBBDBHDHDDBHHBDBFFDHHBDFBDFDHFHFBBDDFBBFBDBHHHBDHBFFHBHDFBDHFDBDDHFFFBDBHFDBDDFBDDBFHBFHFBFHHBFHFFBDFHFHDHBBFDHFBBHDHHDHHHBFDBFBHFDHHHBHDBBHBBDBFHBHDF
FuriousMane38	HBFBHBFBHBFDDHFFDHDFFHFFHFHBFBDBHHHFHFDDFHHFBDHFFBBBBFDDBBFHDHDBBFBHDFFBHBHFDFFBDHBFHHDHBHFHDHBHHDBHFFHBDDBHFHHDHDBHDFHBBDFBDHHDFDDHBHDFHDFBBFHHFDFHHBDHHFFHBDBHFFHHDBDHBDHDDFFBHHBFHHFFBFHBHBFBFHDHHDFF
DapperTail30	FDBFBHDBHFBBBHFBFBBDFDFHDBFDHFDFHFFBFBHHFBDBDHDHHFDFBBFDHFDFFDDHHFBDHBBDDBDHDHDDDDBHBHHHFHBHDFDHBHFHFHDHHFDDFFDFBDHFFBHDHBBFHDDDFBDFDFDBDFFFHBHBHBHDBFFHDFHFDHHFDFBFFDBDFDHHHFBBHFFBHHBBFDFBDDFFDDDFFBDF
LazyWhinny10	BFFFFFDHBFHDHFBFBHFDDBHFDBFDDFDHDHFHFBBBBFFHDHDDHFHHFHDHBHDBFHHHHDDFHFDHBBHFHBBFHFFHBDDFDHFDBFHFDHBDFBBHHFFBDDDBDFBBHDDBHHBFHHFBFDDHFDHHFHBDDDFBHFHBDFFBBBBHHFBBDFFBBHFFHBHHBFBBHDDFBDHFFDHFDFHDDDDHDBFH
HungryMane61	DDBDDFHHDBHBDHFHFFFFDFHFFHFHFHDDHFBDHFHDDHHFHHHHHFBBHBDHDBBDBBHDBDDFFBHBFHBHFFFBDDHBDFBHBBFBDHDDDDFHDHFBHDBHFBDBDFFHFFFBHFHFFFHBFFBHFDDHDFDBBDDFBBHFFFDFHHBHFFHDBHDDHDBDFDFHBBFBHBDHDDDDFDBBBDHDFHBBFDBB
SneakyWhinny57	BBDBHFBBDDDDDBDDBFBBFHBHBBHFDBHDFFFBBHDHFBFHFDBHFBDDFDDFHDDHHHDBDFHDBBDBDFDFBDDHBBHHHBDHBFBDBHFBDFFHDBDBFFBDBFBDDFFFBHBBBBFHFBDDBFDFFBDDDHDBDHFBHHHBBHBBFFHFFHHHHFHFBBHFFFBHHBBFHHHDDHHFFFBDDHDBFDFHHHDF
CharmingSteed90	BFBBHDFHFHBHFHFDHFHHBBHBFFHHHHFHDBFFBHBHFBBHBDHDFBFFDBHBHDBBHHFHBHFDFFDHBHFBBHFHBFHBFFFDFFDDFBFDDBFHBDBBFHDFBDHBBHBBBDBBFHDFDFHHHHFDDDDDDFBBFDFDBHHDHHBHFDBDBBHBFFBBHFBHHHDBHDFBHBFHHHBHHHDDBHFHBFBHDHFH
GallopingTail13	DBHDDDDBBFBDHBHHDDDBFHHDBDBFFDBBBBBFDBHDHFHBBHFDHHDHBFDBFDDDHDDHHDDFDFBHHHDDDDFBDDHFDDBDDFBBBFFFHDHHBDDBHBDHDHDDDFBHBFBBDDFBDFHDDHBFBHDBHHFFDFDFBDHBHDBBHDHFBFDHFBFFHDFHDDFHBFBDBFBDFDBHDFHBHFFDDFDDBHHF
LazyHoof11	FFDBHHDFFDDBDDHDDBDHDFBHHDFHBBHDDBFDDDDFDDBDBDDHFBHHFDDBDDDFHBHFDFDFFHHDDFBHHBHHBHBDDHBBBFBFBBBHDHFFBBDHBDBBFFDHFHFBHHBFHHFBDBBFBDHDDFBDFBFDHBDFBHDFDFBDFHHDDHHHDDDFFFFHDDBDBBFHBDDDHFHHFBDFBHBHHDDBFHHD
HungryGalloper3	FBBHBDDBDDHDBBBBDFDHBFHHBHFFFDFDBBDFHHFDDFFHFBHBDHBBDBBHBBFBDBFBBHHDFDDFHHHFDDDHBHFFBHHDFDDFHFHHBFBDDFDDHHBDHBFDDHFFDFDHDDDDBDDBFHDHHBHFHBDDFDFHHHDHFFFHHDFHDDDFHBFHFHFHDDDHHFFHBHBDBDHFBHFFFFFFFBHFDDFF
LazyGalloper10	FDBHDHFHDBDBBHHDHDFHBBFDFDBHFFHFFDDFHFDDBDDBBBFDHBHDHHDDHDDDFFDBDBFDDDHHHBBHDHFBHBBHBHDDDHDHHBHBFDFFHHHDBHFBDBFBHHDBDHFBDDHHBDHBFBDHBBFFBHDDHHFDDFDBFDHDHDFBDDFHBHFHFBBHHHBBHDFDFFBHBFDDHFHDBDFHDDBHDBFB
CharmingHoof70	FBDBHHFBHDBDDDFHBHBHDBHHDFDFBHFHBDHHDBHHFDFHDBHDDFDDDDDHHDHDFBHHDDHFBFBHFFFDFDBDDDHDFBDFFBDFDBDBBHDFBHFHBHFBHHDDDHDDDDDHBDHFDDBBHDDHHBDDHFDDHDFHFBFFBBFFHHFHDHDBFHFDDHDFFHDHHBFFDHFFBHHFDDFDFDDDDHFDBDHD
LazySteed8	HHFFHBDBFBDDDFDHDFBBBHBBFDHFHBDHDHDDBHBHHFBBBHFFBDBBBBHHFDBHBHBDHFDFFFHDBDBBBBBHBDHBBHFDFFHDBBDHHFFDFBBBHFDBDFDHFBHDBHDFDDBBFBFBBHDFDDHFFDDDDBFBBDBBHDFDHHFHHFFFHHDDDDDFBBDDDDBDFBFFFBBHFDHBHDHFDDFDDBDD
CharmingMare60	HFBBFHBFFFFFFBBDFDDFHDHDHHBHBHHHBHFDHFHHHDFDDBBBBFHDHHDBHFDFHBFFHBDHDBBBFFDHBBBBBDFDFBHDFFBHHBFFFHBDBDDBDFDHHDHBFFHFFFFFBFHHBHHBFBBBDDDFBFDHDBBBHDDHDDBBHDBBBHFHFDHHBDHHBHBFBFHBDHHDFHBHHDFFHDHBFHBBDFBD
GallopingHoof25	FFDBDFFHDBFHFBDBHHBDBFFBHFBFHFFBBFBDFDDHDHHHFBHFDDDHFBDHBDFDBBDHHFDHFFBBBDFDFBDHBHDHBFFHDBDHHHHHDBDDFFBBHFHHFDDFDHHBBFDDDBDBDDHFDHBHFHFFFFFDHHBHFDFFHFFHHHHDDBFFDDDDDDFDDFFDDBFDBHDDDHDFFHDDFHBBFFBHFHFH
DapperMare10	FDDBDFDDBDDDBBBFHFFBDHFDFFDHFHHHBFDBHDFFHBBBHDFDHDHBDFDFHFHDBHDDHBHHBDFDBFFHFDBDBFBFFFFHDFDBHDBBBHHFBBFFFFDFFHDFDHDBFHHFFBHDDFDBBBFHHFBHHDFBHHBHHBDFHHBFHFDBHFDDDFFFBDFBHHHHDFDHDFDDBFFDHFBFBFHFBFFDBFDB
MightySteed6	HBFFDHFBDFHHHDBBHFBDDHHDBHHHBFHDFHHHBDBFBHBBHDDHDHFFDDBBBDBHFBDFDHBDHFDBHHBDFBHHFFBHFBBDBDHHBBHHBFHDBBHDHDDBHDBBBHHBBBDDBDFDBBHHFBFFDHBBBFHBBBFHFDHHHDHFFFBFDBHHDBFFHBDDFHHHBHDBBFDDBHHBBHHFBDFFHBDFHBHH
MightyColt71	DHDDBDBDDDBBBDBBHBFHDHBBDBHBFDFBFBBHFFDHBBDHBBDHBHFHHBDBHHFHDBDHHHDBDHDBHDFHFBDDFBBBHBBHBFHDDBHFFHFBHBDBFFHBHBBBDHBHBBBBDHHFHHFHBHHFBDDFBDFFHBFBFHDBDHDHFDFFFHHDFHFFHHHDBFBBFBDBDHDDDBBFDHFFFDBDBFFHBHHD
HungryGalloper11	DHFDHHBBDBHHDBHFDHBBHBFDHHBDFBHFBFHBHDFDFDHHBHHFHFFDFBBHDDDBBFHFBDBDDFBFFHFFHHFFDFDHFBFHDHBFHBHBDDHDFFHFDFBFDHFDBDBHHBHHDDHFFBFDBHHBBFHFDDHBBFBFDDBFBBHFBFBFBFFHHBFFHBFDHHHFHBHBBHFFFHBFFDHHFHHHHBFFBBHD
PrancingWhinny69	HFBFFBHBDFFFHDFDDBBDHFDBHBFFBBDBFFHHFDFFBBBBFFDHFBFBHDHHHHDFFHBDBHBFFHHBHBFDHHBHFBFHBBDBBBFBBBDFDDDFHBBDFBBFDFHFDHFDDHFBFBHDFBBBBBHFFDBDDDHFDBDBFHFHFBDFDBFHDHBFDBDDDFHDBHHFHDFBDFHDDDFFHBBDFFHDHDHBFFHF
MightyMare21	BBDBBFDBFDHDDDDDBFBFBFBHBHHHBDHHBDDHFHFDFBBBDBFDBDHBHBBBFHFHDDHFBHHFHBDBDFBDHHDDFDFBFFFDBBDHFDBHDFHFDHBHBFDDDHBBFDBDFBHHHBDBFFFBHBDDHBFFFFFFFFBBHBBDBDHBDFBFDFHFBBBDBDHFHHDDHBFBHDDBFDFFBBFBDFFFHFHDFHFD
SwiftTail31	HFDBFFBDHBBDHHFDDDHDFBDFBDDDFHFFFHFFFHDFHBBFBBBFFBDFBHHDFBDFDDBBHHFDHBFDBHHHBHFBDBBHFFFFFHDFFDDFDBFFDBFFBDDBBFBFHDHHBFDBBHDHDBFFHBHBHHDHHDBBBBBBHBFFBDHDFFHDDHFHBDFDDBFBDFDBBBBDHDHHDFDFDFBBBBDDHDHBBFHD
PrancingHoof38	DDFHFHDBBHBDFFFHHHFFHDDDHFHDDHDFBBFFFBFBBFDDDDBHFHHHFBHHHBBBDDHBHBHHFFFDFHBBFBHHHBHFDDBHFDHBHBDFBHFBDFBFDFFDFDHFDDDHDDHFDBDFDBDDBDHDBFBHFHBDDDBHBDHFDDBDHFFBBBBBHBFHDFHBDHFDDFBFDFBHFBHBBFHDDHHFBDDHBBDB
HungryGalloper11	FFHHHFHBFBBFBHHFBBFDFBBHHDFBBBDBHDDHBBBFFDHHHFBDDFHHDBDHBFFBBBFHDHBFBBDDBFHDBHDDFBHDDFBDBBHBBBHFBHDFBBHDBBBDHBHBDFFBHBHBHHBDFHBBDHFHBFBHBBBHDFHDDHDHHHDFBHBDHHDDHFBFHDHFHFHFDFDHFBFFDHBBHHDBFFBBBBFFBBHB
DapperPony11	BFBDHBBFHFHBBHBDBFDFBDHHBBHBHHFHFBFFDDDFBHBDBHHBHFBHHBHFDBBBDHBDHBHFDFFFDDFDDFDHDHBBBBDFDBHHDDDFDFBDDHBFBBFBHDDFDHHBFBDFBFHFFBHBFBFDFBFDHBBDDHFHFFHBDDDBBFFFDDHFDFFFHFBFDDFHBDFHDBDDDDHHBFHFDDDBBBFDFDBH
PrancingTrotter99	HBFBFFBFHFBHBHDFDBHBFBBBFFDBBHDDBDFBDDFHHFBFBBFHDHHBFDHBHDBHDFDFDFBHFFHBHHBFHBDHFHDHHBHBFHBHBDFDBFFHDBBBFHDBHDHHHFFHDHBDFHFHDHBHHBDFBFBBDDHFHHFHFDDFDDBFBBFFDDHHBFDHDHFFDHHDBHFHFBDDBHDDFFFHDFBHDBFDHBHB
FuriousWhinny31	DFHHFHBBFBBBBDDFHBDDDFHHBFHFDFHDHFBHDBFFFFBBFHBFHBFHFBFHFFFBFFBFDBFFDBHFDBDFHFHBDBDDDFDFBBBFHBDDDHFBBDFFDFHBFFHDBFDHDDDFFFBFHBFBFBDDFDHBHBBFDBDDBBHFBFBBBHDFFFHBBDFBDFFDBFBDDFFBBFHFBHDDFBFDFHHDBHDBDDHH
SneakySteed84	BHBHFBDHHBBHBFFDHDHDBDFDBFBDDHFHDHBHHBFFFFFHBDDHBFBHFHHBFDDDDBBHFDBBDFBBHBFDHHFBBBBDFHFDFHHFHHBHBDBFBHDBHDBHHFHDFFHHFHDHBDHHBDFFHFBDBFDHFDBDHFHBHDHHBDBBBFDHBDFFFBDHFDBBDDDDFFDHFDDBHHDHFDBFFDFBBFDDDHBH
FuriousHoof25	DFHHHDBBDBHFBHDHDDBFHHBHHFFBHBDDDDBFBBHDHHHHHDBBBHHFDFFDBBHHDDDDBBDBHHBHHHBBFBDBBFDBHHHDFFHBFHFBFBBDBBHHDFFHHBHFDDFHHHBHDDHFBDFHDFDBFHFFDHBHDDHFHBDHFHBDDFDDDHFHBHBBBFFBFFDHDDHFBHBFHDHDHHDHFHHBBDDFDFBB
HungryWhinny15	FDBHBHDFDBBFDDBBFDBFDHDBDHDFDFHHBDBDFDHDDDHHBBFFDHBHFFFFBFHBBFBBHBBFDFFBHHBBDDHFFBDDDBBBHFHFBBBFDBDDHFDDBHBBHFHHBHFHBHHDFBFBFBHFHBBFFHHFBHDDFHFBHDHDDBFBBFHDBBBFFDDHDHDBHDFHHDFHBHDDHDHBFBHFHDHHHHHBBHDD
FuriousTrotter56	BBBFDHFDBHHBBHBDHFBDDHBFFBFHFFHDHFHHHFHFHDDHFDHFFFHBFDDFBFBBDFHBFHFBHDBHFHFBHFBHBHHDHDBBBBDDDBDBDFDFHFHBFBHFFBDDBDHFHDBHFHDDDHBFHBFBDBHFFBDHBHHBDBHFBHFDHBDFBFDFFBFHFBDBBHDBDHDFDFFHHDFDDDBDBHHHDDFHDDFB
GallopingTrotter75	HDDDDBBFFDBDHHDHHFDFBFDFDHHFBHFBFFFDDDBDDFHFFBFHBBBHDBBDDDBFBDFHDBFBHFFBHFBFFHDFFBBBBHFBHDBDDHHDBFBFHBBBHHBFFFDHFBFBBHFFHDFFDHFDFDDHDFBBBFHDHFDBBDHBBBFFDDDHDFDDFDFFBBBDHFFBFFFFBFBHBHDBHBHHDFDFBFHBHHHD
SwiftMare98	BBBDDHBHDDBHBHFHFDDHDHDDDHDBFBHHDDDBDHHBBFDFDDDHFFBDDBBDDHDBDFBBDBBDHBBBBDHHBFFFBHHBHHBHHDHHHDFBFFFFFBHBHHBBHHBBBHBBHBDHHHBHFDBHBDBBFFDHFFFHDDBBHDDBDFHHBBBDFFHFBBBBFDFDHHDFBFDHDBHFFFBFFDBFDDHHDBDDDBFD
SwiftGalloper3	HFDBBDFFHFDHDHFBFDFDHBFHBFBDDHDDFFBHBDDDBBHFBDDFFHDDBDFDFHHDFFHDBBFHHBHFHDDHBBBDDDHBFHHFBFDDHDFDFHBHBHHFDDFFBFBBHFBBHFFDBDDFHBDBDDDBHHDHFBDHFBBHHDBHDBHHHHHBHFBBBBHFFDBDBBHFHBBFDDDBBHFDFDHDFFHBBFDFBFHD
CharmingColt7	DFDHFBFBBHHHBFDHFDBFHDDDHBDBDBFBFFBBBDDHFBBBDDBFHBFBHFFHBDFDHFFDFBFBDFHFBHBBDHDDBFFBFFDBDHHFBDBDFBFBBBHFDHFDBDFHHHBHDDBFBFHHFFHBDHHFBDFDDFDHBHFBBHFBBBHBDFFDBFHHFHBHFDDFHDFBFFBDHFBDBHDDFDHHBFBHHDBFDBFH
LazyMare17	FBFHBDFFDBDBDBHFHDBBBFBDBHFBDHBFBDFFHHHDFFBDFFBDFHBBDFHDDFFHHFHHFDFFFHHDDDBHBFDBFFDDFBFDDFFBHBDBDBBBHDFHFBBFBBHHHFFFHHFFDHHDDHBBDHFDBFBBFBHDBBHHHHHBBBDHFFFHHHDDBDDDHFBDBBBDDHFHFBFBHFDFHDFHFHBHHDDBDBBD
PrancingWhinny14	BBFHDFDDFFHDHBFDDDDFFDDBHFFHFFHHDBFHBFDFHFBFFBBHHBHHBHBBFBFDFHDHBBDFFHDBHDHHBHBDBFBFHDHFFHFFDDDDHBBHHDFFBBBDFFBHBHHFHHFHBFBHBFFDHFBDFBDBDDFFBDFBFDDFDHHBBHHFFBFDBFBHDDHDFDHDHBFDHHFDDHHHBFDFBHFFHFFHHBFB
SneakySteed81	HBFHFHFBHBHDDHHHFFDBBBBBBBFFHFHDDFBFFHFFDFDHHHHDDHBDDBHDHDBFDFHHDDFFBBHBBFDDBBBDFBFFHBBFDFBBFFFFHDHBHDDBHBHDHDHDHDDHBDBBDHDBBDDDDDDHFHDBDHHFHDFHHBDDBHBDHDDFFFHDBFFFHBBFHBFHDDHBDBFDBFHFFBHHFBDFDFHDDDHF
GallopingWhinny40	HDFHFHDDBDDHFBHBFFBHHHFBBDFDFBBBDDFBFHDHFBDDBBFHBHFBFBHBFFHBHHBFDHHHHFDHHFHBBFBDFFDBHHHBDHFFBHHDHBFBHDBFDFFFHFBBFDFDDHHFDFDHDFDBFHDDBFBBHBFFHDBBFHFFHHFFFDBHFDDDDFHDFHHDHDFBBDFDBFFHBDBDHDDDHBBHHHFDDHHF
GallopingGalloper16	HDHBBDHFDHDFHDBBDBHDFFDHFDBFBFBFBBBFBDBBHFHHFBBFBBBHDDHDHBHHHFFBBFDFFFHHFBFHHBFFBBDFBBFDDHDFBBHBDDBBBHFBFFFHDHFFHBBBDFHFDDDBFBHHBFDBFFHFBDHHFDDHHBDHBDDFBDHDFFFDBHHHDHBFDFFBFFFBBHHFHFBHFHBFDDFFBBHBHHDF
SwiftHoof53	FDDDHFFDHHHFDDBFFDFFDFFBBFBFBDBFDDFHDFHHDBFHBBFDBDHDBFDDFHDFHBHBDDBHFFHHBFHFBBHDFFDDHFBBBFBBHDHHBDBBFHFDFBHBBDBBDBDDDFDDHHDFFBDFHDBHBBFBHHFHFHDFFHFHFDHBBBHBFDBDHFDFBBBBHFFHDHFBDFBFBBFFDHDDBBFHBBBDFBBF
HungryPony52	DDDHDDDBDFFBBBBDBDHFHBHDHDDHBFHDDHBBFDDDHFDHBBBBBHDBFHDFBHBBDDDBFBFFDBFBDDFFFDFDFBFBDDBFFBDBFHBDHDDFFDHHHFHBHBFDFDFBDDFHBHBBDDHFHBHDFDDHDDFHHBDDBDBDDFDHHHHFHHHHBFFDDFBDDFDBDHFHBDFHDBDDHBFBBFHHBDDHDHDD
CharmingSteed69	FBDFFBBDHBFHBFBBBDBHHHFDHFFBDHBDBDDFBBDBFFFHFFFHDHDDHFDHBFDBFDFHDHHHBDBHFFDDDHDBBFFHBDDHHHDDBBHHDFFFBDBHBFDFHBDDDDHFFHBHHHFBBDFBBHFFHDFBFBBHHBBHDBFBBDFBHBHDBHBDFFDHDDDBDBHHBBDFHDHBBHFDBFHDHBDHDDDFHBHB
LazyMare29	HDFHBBDFBBHBBBBDFBDHBBBDDBFDDHDBFBBHHBBFFDFBHBHFDBFFHFBHHFBHDBHFFBHBDDHHHDHHDHBDHDFDFDDHHHDBFDBHBDFHHHHBDFDBDFBFFBDBHDBFDFFBHFHBHFBHDBFFDFDDBDFDFHBDBFDBFBBBDHBBDDFDDFFBBFDBDFDBHDBBDDHFDFBDBHFFDHBBHFHD
MightyGalloper75	FFBHFHDDHHFHHBHDBHBBFFDHFBDHFBDFBFFHBDDDDDBDHDBDDFHBBBHDDFDFFFFHBBFFHFFBFBFHBFBBBBHFBHDDFBFBDBDBHHBFDBHFDBFHDBBDFDHFBFBHFHFHBDFHDHHBDHFDBDDBHBDDDHHHHHFFHFHDFDHDFFHFDDBFDBHFDFBFHDDBDFBFBHFDDBFHDDBBDBFF
SneakyGalloper65	DBFDBHHBFFDDBHDDDBHHBFDFFBBHDBFFBBDFFBHBFBFDBDDFBBBDDHHBDHBFHBBHFHDDFBHFFBHDBBDBHBFFFDDHBDHFFDBBDHDDHDHDBBFHBBHDDDHBFHFFFDDBFFFDDFDHBFBFHBHHFDFBHBHFFBHHDBDDBDDFBHFDHFBFDBDHDDBHBHFBFBDBBDFHHBFFFHDHDHBH
DapperHoof87	FHBFFBBHDDHDFDBFFHFDDFDBHHBFBFDBBDBHDBDHFDDDFFHFFDDFBBHBDHFHFBBFBFFBHDBHHFDDFDBHDDHDDBHFBBDDBHHBDBHDDHHBDBFFFHFDHDHHBFFBBFBDDHFFHFDFBDFDDFBHHBDFHFFFHHFDHHDDBHDHBFDHBBHDDHHBHBFHBBBDDDDDHHDBFFFHDBHDBFDH
CharmingTrotter18	BFHBFDDDFFDHBDBFBHFHBBBDDHBDBFBDDBBBBFHDFBFFFDDFFDBHDFFDDHBFFHFFBDHBHBHDDDHDBDBFFBFFBHHFBBFHDFBBBFBFBFBHHFDFFBDDDFHBDDBFBFDDBHDBBDFDDFHBBDBDHHHHHBHFDDFBFDDHBDBFHFBHBHBHDDFHBDBFDBDBBHFFDBDHFBBBBDFFFBHH
MightyColt54	DFDHDHDDDDDDHFHDHHDFHDBDHFFBFFDBDBHHHDHDHDFBBHBBDDFBDHDDFHDHHHDFBFFDFFDDHFDHBDDBBDBFBFFDBDDDBFDDHHBFDFFBHBDFBHHHFHHHDHFHBDBDFHDFDBDFHBDBBHFHDDHBHHHHHHBBFFBFFFDHDFHFFFHHBHBDHDFDFHFBHFDHHFFDDFHBFHFFHFBB
SwiftHoof75	HHFHHHDFHDDFDDFHDBFFFFDBHBFHFBBFBDFBFBDDBFBFBFFDDHDHDFBDFDFFHHBHHDBBFDFDDBBHDDBFBBBHFFHDBBBDDHDBDDFFFDBHFFBFFDDBFHBDHDBBDFHBDBHHDFBFHBDBBFHDBDHFFDBFHFHBBHHHFDBHDBFBDDBDHBBFFHHDBBHFFBFBDFDHHFDFDFBDHDBF
LazyPony25	DFBBBBBBBBHFHDFFBHFHFDFDDDDFBDBHFFBBFFHFDDDHBHHDHHDHDFDFBDDBFDHDHFFHDFDHFHFHFHHDBFHDBBDBBHHDDHFDHBHBDHDDBBHBDBFBDDDFHHFHBBBBBBFFBBHDBBFFFFDBFBDFHHDFFHHFFHHBFHHFBFBDBDBDDDHFHHHFDDDFFDBDHFHFDDFBFBBFFBBD
MightyHoof31	HDDDBHDDFDBBDDFFHHDDHHFDDBFBHHBFBFFFDFBBBBFFHFDBBHHHBFBFFBBHHDFDHHBBHFHFDHBDDFDFHHHBHHDHBHFFBFDBHFBBBDHDDFHBFDFFBHFBHFDHFDHFBHHHDBFFFHDBDHBBHHFFHDFBFDDDBBDFFFBDFBBDDHBDFBHHHBBDHHBHBBFDFBFFFDDHBDHDDBBF
MightyGalloper36	HHHBFHFFDDBFDDDBHBBFDBHBHHBFHFHFHFBFFFFFHFFFBHFDBBBFFBBBFBFFHBBFBFDBHDDHFFDBBBHBBFDBHDFFDDFBDHFFFFDDDHHDFHDFHFDHHDFHBDHHHHBBBFBDDFBDHHBBHBBBHFBFHHBDFBHHHBBDBBDFBDHDBBFFFFHHFDBFDDHFDBBHFHDBBHBBFFDBBHHF
